Mammal = Động vật có vú
Reptile = Động vật bò sát
Amphibian = Động vật lưỡng cư
Bird = Chim
Fish = Cá
Insect = Côn trùng
Predator = Động vật săn mồi
Prey = Động vật con mồi
Herbivore = Động vật ăn cỏ
Carnivore = Động vật ăn thịt
Omnivore = Động vật ăn cả thực vật và động vật
Endangered species = Loài đang bị đe dọa
Extinct species = Loài đã tuyệt chủng
Habitat = Môi trường sống
Ecosystem = Hệ sinh thái
Wildlife = Động vật hoang dã
Domesticated animal = Động vật đã được thuần hóa
Pet = Thú cưng
Farm animal = Động vật trang trại
Wild animal = Động vật hoang dã
Zoo = Sở thú
Safari = Cuộc đi săn
Conservation = Bảo tồn
Migration = Di cư
Hibernation = Ngủ đông
Camouflage = Sự ngụy trang
Adaptation = Sự thích nghi
Food chain = Chuỗi thức ăn
Food web = Mạng thức ăn
Carnivorous = Ăn thịt
Herbivorous = Ăn cỏ
Omnivorous = Ăn cả thực vật và động vật
Venomous = Độc
Poisonous = Gây độc
Exotic = Kỳ lạ, ngoại lai
Endothermic = Động vật có nhiệt đới
Ectothermic = Động vật không có nhiệt đới
Scales = Vảy
Fur = Lông
Feathers = Lông chim
Wings = Cánh
Beak = Mỏ
Claws = Móng vuốt
Hooves = Móng guốc
Tail = Đuôi
Mane = Tóc (của sư tử)
Trunk = Vòi (của voi)
Tusk = Ngà (của voi)
Horn = Sừng (của động vật)
Elephant = Voi
Dolphin = Cá heo
Giraffe = Hươu cao cổ
Koala = Gấu túi
Lion = Sư tử
Kangaroo = Chuột túi
Bat = Dơi
Tiger = Hổ
Whale = Cá voi
Monkey = Khỉ
Snake = Rắn
Crocodile = Cá sấu
Lizard = Thằn lằn
Turtle = Rùa
Gecko = Tắc kè
Frog = Ếch
Salamander = Kì lân
Eagle = Đại bàng
Penguin = Chim cánh cụt
Hummingbird = Oanh
Shark = Cá mập
Clownfish = Cá hề
Salmon = Cá hồi
Goldfish = Cá vàng
Butterfly = Bướm
Ant = Kiến
Bee = Ong
Dragonfly = Chuồn chuồn
Cheetah = Báo đốm
Wolf = Sói
Polar Bear = Gấu Bắc Cực
Komodo Dragon = Thằn lằn Komodo
Deer = Nai
Rabbit = Thỏ
Gazelle = Linh dương
Cow = Bò
Horse = Ngựa
Bear = Gấu
Pig = Lợn
Human = Con người
Raccoon = Gấu trúc
Zebra = Ngựa vằn
Ostrich = Đà điểu
Rhino = Tê giác
Fox = Cáo
Bat = Dơi
Chimpanzee = Tinh tinh
Owl = Dế mèn
Gorilla = Khỉ đột
Peacock = Công
Jellyfish = Sứa
Octopus = Bạch tuộc
Starfish = Sao biển
Seahorse = Ngựa biển
Alligator = Cá sấu
Porcupine = Nhím
Armadillo = Động vật có vỏ bọc
Bison = Bò rừng
Cheetah = Báo đốm
Chimpanzee = Tinh tinh
Dinosaur = Khủng long
Donkey = Lừa
Eagle = Đại bàng
Ferret = Chồn nhỏ
Gazelle = Linh dương
Hedgehog = Nhím
Iguana = Thằn lằn Iguana
Jellyfish = Sứa
Koala = Gấu túi
Lemur = Linh lùn Madagascar
Meerkat = Sóc nhỏ châu Phi
Narwhal = Cá ngựa vằn
Octopus = Bạch tuộc
Pangolin = Gặm nhấm
Quokka = Loài động vật buồn cười
Raccoon = Gấu trúc
Sloth = Lười
Tasmanian Devil = Loài quỷ Tasmania
Uakari = Loài khỉ Nam Mỹ
Vulture = Kền kền
Walrus = Hải mã
X-ray Tetra = Cá Neon
Yak = Bò tây tạng
Zebu = Bò Zebu
Albatross = Đại bàng biển
Axolotl = Thằn lằn axolotl
Bumblebee = Ong mật
Dingo = Chó hoang Australia
Elkhound = Chó săn lớn Na Uy
Flamingo = Hồng hạc
Gecko = Tắc kè
Hummingbird = Oanh
Ibex = Dê đá
Jackal = Chó sói châu Phi
Kingfisher = Chào mào