Hairstyle = Kiểu tóc
Eyebrows = Lông mày
Beard = Râu
Mustache = Ria mép
Complexion = Da dẻ
Freckles = Tàn nhang
Wrinkles = Nếp nhăn
Dimples = Móc nhỏ
Scar = Vết sẹo
Birthmark = Vết nám
Acne = Mụn trứng cá
Pimple = Mụn đỏ
Blackhead = Mụn đen
Skincare = Chăm sóc da
Makeup = Trang điểm
Lipstick = Son môi
Eyeliner = Bút kẻ mắt
Foundation = Kem nền
Mascara = Mascara
Blush = Phấn hồng
Eyeshadow = Phấn mắt
Nail polish = Sơn móng tay
Hairstylist = Người làm tóc
Barber = Thợ cắt tóc nam
Haircut = Cắt tóc
Hair color = Màu tóc
Blonde = Tóc vàng hoe
Brunette = Tóc nâu đen
Redhead = Người tóc đỏ
Bald = Hói đầu
Ponytail = Đuôi ngựa
Braid = Tết tóc
Afro = Kiểu tóc Afro
Wavy = Tóc xoăn
Straight = Tóc thẳng
Curly = Tóc quăn
Frizzy = Tóc xoăn và rối
Thin = Tóc mỏng
Thick = Tóc dày
Long = Tóc dài
Short = Tóc ngắn
Bangs = Chẻ tóc
Updo = Kiểu tóc buộc lên đầu
Part = Phân đường tóc
Sideburns = Râu quai nón
Cheekbones = Gò má
Jawline = Đường hàm
Chin = Cằm
Lips = Môi
Eyes = Mắt
Nose = Mũi
Ears = Tai
Forehead = Trán
Neck = Cổ
Shoulders = Vai
Arms = Cánh tay
Elbows = Khuỷu tay
Wrists = Cổ tay
Hands = Tay
Fingers = Ngón tay
Nails = Móng tay
Hips = Hông
Waist = Eo
Stomach = Bụng
Hips = Mông
Thighs = Đùi
Knees = Đầu gối
Calves = Bắp chân dưới
Ankles = Cổ chân
Feet = Chân
Toes = Ngón chân
Posture = Dáng đi
Gait = Bước đi
Graceful = Duyên dáng
Athletic = Cơ bắp săn chắc
Slim = Mảnh mai
Fit = Sức khỏe tốt
Plump = Mũm mĩm
Elegant = Lịch lãm
Trendy = Phong cách thời trang
Stylish = Phong cách
Casual = Bình thường
Chic = Sang trọng
Fashionable = Đẹp mắt
Trendsetter = Người làm mốt
Well-groomed = Chăm sóc bản thân tốt
Radiant = Rạng ngời
Handsome = Đẹp trai
Beautiful = Xinh đẹp
Attractive = Quyến rũ
Stunning = Ngoại hình gây ấn tượng
Charming = Dễ thương
Alluring = Mê hoặc
Magnetic = Quyến rũ như nam châm
Youthful = Trẻ trung
Mature = Trưởng thành
Grizzled = Tóc bạc pha xám
Wrinkle-free = Không nếp nhăn
Glowing = Tươi sáng