Apple = Quả táo
Banana = Chuối
Orange = Cam
Strawberry = Dâu
Blueberry = Việt quất
Mango = Xoài
Watermelon = Dưa hấu
Pineapple = Dứa
Grapes = Nho
Kiwi = Kiwi
Avocado = Bơ
Tomato = Cà chua
Cucumber = Dưa leo
Carrot = Cà rốt
Broccoli = Bông cải xanh
Spinach = Rau cần tây
Lettuce = Rau diếp
Potato = Khoai tây
Rice = Cơm
Pasta = Mì ống
Bread = Bánh mì
Cheese = Phô mai
Chicken = Gà
Beef = Bò
Fish = Cá
Shrimp = Tôm
Salmon = Cá hồi
Egg = Trứng
Bacon = Thịt ba chỉ
Sausage = Xúc xích
Pizza = Bánh pizza
Burger = Bánh burger
Sandwich = Bánh sandwich
Soup = Súp
Salad = Sa lát
Sushi = Sushi
Ice cream = Kem
Cake = Bánh ngọt
Chocolate = Sô cô la
Cookie = Bánh quy
Yogurt = Sữa chua
Noodle = Mì xào
Curry = Cà ri
Pancake = Bánh bánh kếp
Omelette = Trứng ốp
Quinoa = Hạt lúa mạch
Hummus = Nước sốt đậu nành
Tofu = Đậu hủ
Caesar salad = Sa lát Caesar
Guacamole = Sốt guacamole
Water = Nước
Tea = Trà
Coffee = Cà phê
Juice = Nước ép trái cây
Soda = Nước ngọt
Lemonade = Nước chanh
Milk = Sữa
Iced tea = Trà đá
Iced coffee = Cà phê đá
Smoothie = Sinh tố
Hot chocolate = Chocolate nóng
Wine = Rượu vang
Beer = Bia
Cocktail = Cocktail
Champagne = Rượu champagne
Whiskey = Rượu whiskey
Vodka = Rượu vodka
Rum = Rượu rum
Margarita = Cocktail Margarita
Mojito = Cocktail Mojito
Cola = Cola
Green tea = Trà xanh
Black tea = Trà đen
Herbal tea = Trà thảo mộc
Orange juice = Nước cam ép
Apple juice = Nước táo ép
Grape juice = Nước nho ép
Coconut water = Nước dừa
Almond milk = Sữa hạnh nhân
Soy milk = Sữa đậu nành
Sparkling water = Nước suối
Ginger ale = Nước gừng
Fruit punch = Nước trái cây hỗn hợp
Red wine = Rượu vang đỏ
White wine = Rượu vang trắng
Iced lemon tea = Trà chanh đá
Cold brew = Cà phê lạnh
Espresso = Espresso
Cappuccino = Cappuccino
Latte = Latte
Matcha latte = Latte trà xanh
Frappuccino = Frappuccino
Hot tea = Trà nóng
Herbal infusion = Nước trái cây hấp
Mint tea = Trà bạc hà
Hot milk = Sữa nóng
Iced almond latte = Latte hạnh nhân đá
Coconut milkshake = Sinh tố dừa
Pineapple smoothie = Sinh tố dứa
Cranberry juice = Nước lựu