Nutrition = Dinh dưỡng
Exercise = Tập luyện
Wellness = Sức khỏe tổng thể
Hydration = Sự cung cấp nước
Meditation = Thiền
Sleep = Ngủ
Stress management = Quản lý căng thẳng
Mental health = Sức khỏe tâm thần
Physical fitness = Thể chất
Balanced diet = Chế độ ăn cân đối
Healthy habits = Thói quen lành mạnh
Resistance training = Tập luyện chống nghịch
Cardiovascular health = Sức khỏe tim mạch
Flexibility = Sự linh hoạt
Immunity = Sức đề kháng
Organic food = Thực phẩm hữu cơ
Vitamins = Vitamin
Minerals = Khoáng chất
Herbal remedies = Phương pháp điều trị bằng thảo dược
Mental well-being = Tình trạng tâm lý tốt
Restorative sleep = Giấc ngủ hồi phục
Meditation techniques = Kỹ thuật thiền
Self-care = Chăm sóc bản thân
Healthy lifestyle = Lối sống lành mạnh
Fitness routine = Chuỗi bài tập thể dục
Balanced nutrition = Dinh dưỡng cân đối
Heart rate = Nhịp tim
Blood pressure = Huyết áp
Resistance exercises = Bài tập cường độ
Holistic health = Sức khỏe toàn diện
Antioxidants = Chất chống oxy hóa
Mental clarity = Sự minh mẫn tâm thần
Hygienic practices = Thói quen vệ sinh
Proper posture = Tư thế đúng
Digestive health = Sức khỏe tiêu hóa
Preventive care = Chăm sóc phòng ngừa
Well-balanced life = Cuộc sống cân bằng
Natural remedies = Phương pháp tự nhiên
Holistic healing = Phương pháp chữa trị toàn diện
Nutrient-rich foods = Thực phẩm giàu chất dinh dưỡng
Fitness tracker = Thiết bị theo dõi sức khỏe
Mindfulness = Sự chú ý đầy đủ
Energy levels = Mức năng lượng
Healthy heart = Tim khỏe mạnh
Immune system = Hệ thống miễn dịch
Portion control = Kiểm soát lượng ăn
Body mass index (BMI) = Chỉ số khối cơ thể (BMI)
Healthy aging = Tuổi già khỏe mạnh
Mental resilience = Sức mạnh tinh thần
Proper hydration = Sự cung cấp nước đúng cách
Low-impact exercises = Bài tập nhẹ nhàng
Plant-based diet = Chế độ ăn chủ yếu từ thực vật
Emotional well-being = Sức khỏe tâm lý
Holistic nutrition = Dinh dưỡng toàn diện
Self-reflection = Tự nhìn nhận
Adequate sleep = Giấc ngủ đủ giấc
Mental resilience = Sự mạnh mẽ tinh thần
Mind-body connection = Liên kết tâm thần-cơ thể
Cardiovascular exercise = Bài tập tim mạch
Healthy aging = Tuổi già khỏe mạnh
Portion control = Kiểm soát khẩu phần
Organic farming = Nông nghiệp hữu cơ
Nutritional supplements = Bổ sung dinh dưỡng
Mental clarity = Sự minh mẫn tâm thần
Social well-being = Sự an sinh xã hội
Active lifestyle = Lối sống tích cực
Mindful eating = Ẩn suy nghĩ khi ăn
Bone health = Sức khỏe xương
Healthy cooking = Nấu ăn lành mạnh
Stress reduction = Giảm căng thẳng
Aerobic exercise = Bài tập nhiễm oxi
Healthy skin = Da khỏe mạnh
Emotional balance = Cân bằng tình cảm
Personal hygiene = Vệ sinh cá nhân
Positive mindset = Tư duy tích cực
Whole foods = Thực phẩm nguyên chất
Disease prevention = Phòng ngừa bệnh tật
Mind-body practices = Phương pháp tập luyện tâm thần-cơ thể
Mental fortitude = Sức mạnh tinh thần
Fitness level = Mức độ thể chất
Healthy joints = Khớp khỏe mạnh
Preventive healthcare = Chăm sóc sức khỏe phòng ngừa
Balanced emotions = Cảm xúc cân bằng
Healthy teeth = Răng khỏe mạnh
Positive relationships = Mối quan hệ tích cực
Emotional resilience = Sức mạnh tinh thần
Mental focus = Tập trung tinh thần
Balanced hormones = Hormon cân bằng
Portion size = Kích thước khẩu phần
Fitness goals = Mục tiêu thể chất
Healthy weight = Cân nặng khỏe mạnh
Emotional intelligence = Trí tuệ cảm xúc
Sun protection = Bảo vệ da khỏi tác động của nắng
Healthy hair = Tóc khỏe mạnh
Regular check-ups = Kiểm tra định kỳ
Personal development = Phát triển cá nhân
Resistance to illness = Sức kháng bệnh
Nutrient absorption = Sự hấp thụ chất dinh dưỡng
Mental relaxation = Sự thư giãn tinh thần
Posture correction = Sửa chữa tư thế