Architecture = Kiến trúc
Interior design = Thiết kế nội thất
Furniture = Nội thất
Decor = Trang trí
Renovation = Sửa chữa, cải tạo
Kitchenware = Đồ dùng nhà bếp
Bedroom = Phòng ngủ
Living room = Phòng khách
Bathroom = Phòng tắm
Lighting = Hệ thống đèn chiếu sáng
Curtains = Rèm cửa
Carpets = Thảm trải sàn
Wallpaper = Giấy dán tường
Paint = Sơn
Shelving = Kệ sách
Appliances = Thiết bị gia đình
Bedding = Bộ chăn ga gối
Cushions = Gối trang trí
Tableware = Bát đĩa đồ ăn
Garden = Khu vườn
Outdoor furniture = Nội thất ngoại thất
Lawn = Bãi cỏ
Flowerbed = Khu đất trồng hoa
Patio = Sân hiên
Terrace = Ban công
Arbor = Nhà gỗ mái tre
Pergola = Khu trải nghiệm
Hedge = Bức tường cây xanh
Fountain = Đài phun nước
Deck = Sân
Swimming pool = Bể bơi
Barbecue = Bếp nướng than hoa
Outdoor lighting = Hệ thống đèn ngoại thất
Garden tools = Dụng cụ vườn
Planters = Chậu cây
Irrigation = Hệ thống tưới nước
Landscaping = Thiết kế cảnh quan
Lawn mower = Máy cắt cỏ
Trellis = Kèo hỗ trợ cây leo
Sunroom = Phòng trời
Skylight = Cửa sổ trời
Attic = Gác xép
Basement = Tầng hầm
Chimney = Ống khói
Fireplace = Lò sưởi
Staircase = Cầu thang
Balcony = Ban công
Closet = Tủ quần áo
Pantry = Phòng chứa thực phẩm
Entryway = Lối vào
Mudroom = Phòng giữ giày dép
Porch = Hèm, hiên nhà
Windowsill = Mâm cửa sổ
Skylight = Cửa sổ trời
Wainscoting = Bảng tường phía dưới
Curb appeal = Sức hấp dẫn từ xa
Mantelpiece = Nóc lò sưởi
French doors = Cửa hai lớp
Breakfast nook = Góc ăn sáng
Built-in = Được tích hợp sẵn
Crown molding = Moulding trên đỉnh tường
Backsplash = Phần giữa giữa tủ và trên bàn làm việc
Skylight = Cửa sổ trời
Backyard = Sân sau
Playhouse = Nhà chơi cho trẻ
Hammock = Dải lưới
Garden gnome = Búp bê vườn
Butterfly house = Nhà nuôi bướm
Bird feeder = Hộp cho thức ăn chim
Weather vane = Cột chỉ hướng gió
Arboretum = Khu vườn cây cổ thụ
Treehouse = Nhà trên cây
Swing set = Bộ xích cho trẻ em
Outdoor rug = Thảm ngoại thất
Garden bench = Ghế vườn
Trellis = Kèo hỗ trợ cây leo
Fire pit = Bếp lửa trại
Lanterns = Đèn lồng
Hammock = Dải lưới
Pavers = Gạch lát đường
Deck chair = Ghế nằm trên sân
Lawn chair = Ghế dựa trên bãi cỏ
Gazebo = Dãy cột tre, mái vòm
Topiary = Nghệ thuật cắt tỉa cây cỏ
Garden gloves = Găng tay vườn
Trowel = Xẻng nhỏ
Wheelbarrow = Xe cút kít
Pruners = Kéo cắt cành
Mulch = Lớp phủ đất
Compost = Phân hữu cơ
Hose = Dây nước
Sprinkler = Bình phun nước
Garden hose reel = Cuộn dây nước
Solar lights = Đèn năng lượng mặt trời
Garden stakes = Que đánh dấu
Insect repellent = Thuốc chống côn trùng
Rain barrel = Thùng chứa nước mưa
Garden cart = Xe đẩy đồ vườn
Garden hat = Mũ bảo hộ khi làm vườn
Weed killer = Thuốc diệt cỏ rừng